555555555555555555555555555555555555555555555555
500000000004444444444004444444444000000000000005
500000000004444444444004444444444000000000000005
500000000444400111111001111110044440000000000005
500000000444400111111001111110044440000000000005
500000000444400110011001100110044440000000000005
500000000444400110011001100110044440000000000005
500000000444400111111001100110044440000000000005
500000000444400111111001100110044440000000000005
500000000444400000011001100110044440000000000005
500000000444400000011001100110044440000000000005
500000000444400111111001111110044440000000000005
500000000444400111111001111110044440000000000005
500000000444444222222002222224444440000000000005
500000000444444222222002222224444440000000000005
500000000444444222222002222224444440000000000005
500000000444444222222002222224444440000000000005
500000000444444222222002222224444440000000000005
500000000444444222222002222224444440000000000005
500000000550000222222002222220000550000000000005
500000000550000000011111100000000550000000000005
500000000444400000011111100000044440000000000005
500000000444400110011111100110044440000000000005
500000000441155115511111155115511440000000000005
500000000441100110011001100110011440000000000005
500000000441100110000000000110011440000000000005
500000000441100110000000000110011440000000000005
500000000441100110001111000110011440000000000005
500000000444400000001901000000044440000000000005
500000000000000000000000000000000000000000000005
500000000000000000000000000000000000000000000005
555555555555555555555555555555555555555555555555
