5555555555555555555555555555
5004444444444004444444444005
5004444444444004444444444005
5444400111111001111110044445
5444400111111001111110044445
5444400110011001100110044445
5444400110011001100110044445
5444400111111001100110044445
5444400111111001100110044445
5444400000011001100110044445
5444400000011001100110044445
5444400111111001111110044445
5444400111111001111110044445
5444444222222002222224444445
5444444222222002222224444445
5550000222222002222220000555
5550000000011111100000000555
5444400000011111100000044445
5444400110011111100110044445
5441155115511111155115511445
5441155115511111155115511445
5441100110011001100110011445
5441100110000000000110011445
5441100110000000000110011445
5441100110001111000110011445
5444400000001901000000044445
5444400000001001000000044445
5555555555555555555555555555