555555555555555555555555555555555555555555555555
500000000000000000000000000000000000000000000005
500000000000000000000000000500000000000000000005
500000000000000000000000000500000000000000000005
500000044444444444444000000500000000000000000005
500000044444444444444000000500000000000000000005
500000044444444444444000000500000000000000000005
500001111110000001111110000500000000000000000005
500001111110000001111110000500000000000000000005
500000000000000000000000000500000000000000000005
504440000000000000000004440500000000000000000005
554440000001111110000004445500000000000000000005
554440000001190110000004445500000000000000000005
554440000001100110000004445500000000000000000005
554440000001111110000004445500000000000000000005
554440000000000000000004445500000000000000000005
554440000000000000000004445500000000000000000005
554440000000000000000004445500000000000000000005
554440000000000000000004445500000000000000000005
554440000000000000000004445500000000000000000005
504440000000000000000004440500000000000000000005
504440000000000000000004440500000000000000000005
504440000000000000000004440500000000000000000005
522001111110000001111110022500000000000000000005
522001111110000001111110022500000000000000000005
522000044444444444444000022500000000000000000005
522000044444444444444000022500000000000000000005
522000044444444444444000022500000000000000000005
522000000000000000000000022500000000000000000005
522222000000000000000022222500000000000000000005
522222000000000000000022222500000000000000000005
555555555555555555555555555555555555555555555555
