555555555555555555555555555555555555555555555555
500444444444400444444444400000000000000000000005
500444444444400444444444400000000000000000000005
544440011111100111111004444000000000000000000005
544440011111100111111004444000000000000000000005
544440011001100110011004444000000000000000000005
544440011001100110011004444000000000000000000005
544440011111100110011004444000000000000000000005
544440011111100110011004444000000000000000000005
544440000001100110011004444000000000000000000005
544440000001100110011004444000000000000000000005
544440011111100111111004444000000000000000000005
544440011111100111111004444000000000000000000005
544444422222200222222444444000000000000000000005
544444422222200222222444444000000000000000000005
544444422222200222222444444000000000000000000005
544444422222200222222444444000000000000000000005
544444422222200222222444444000000000000000000005
544444422222200222222444444000000000000000000005
555000022222200222222000000000000000000000000005
555000000001111110000000000000000000000000000005
544440000001111110000004444000000000000000000005
544440011001111110011004444000000000000000000005
544115511551111115511551144000000000000000000005
544115511551111115511551144000000000000000000005
544110011001100110011001144000000000000000000005
544110011000000000011001144000000000000000000005
544110011000000000011001144000000000000000000005
544110011000000000011001144000000000000000000005
544440000000000000000004444000000000000000000005
544440000000000000000004444000000000000000000005
555555555555555555555555555555555555555555555555